link	codpcia	departamento	provincia	mujeres	varones	personas	hogares	viv_part	viv_part_h
06854	06	25 de Mayo	Buenos Aires	18502	17340	35842	12416	15596	12029
06588	06	9 de Julio	Buenos Aires	24582	23140	47722	16308	20204	15833
06007	06	Adolfo Alsina	Buenos Aires	8667	8405	17072	6237	7932	6097
06014	06	Adolfo Gonzales Chaves	Buenos Aires	6138	5909	12047	4199	5211	4090
06021	06	Alberti	Buenos Aires	5473	5181	10654	3828	4939	3725
06028	06	Almirante Brown	Buenos Aires	282655	270247	552902	156918	156204	142614
06077	06	Arrecifes	Buenos Aires	15065	13979	29044	9546	10870	9212
06035	06	Avellaneda	Buenos Aires	180413	162264	342677	113142	121292	103661
06042	06	Ayacucho	Buenos Aires	10352	9985	20337	6967	8408	6768
06049	06	Azul	Buenos Aires	33632	31648	65280	22020	25703	21050
06056	06	Bahía Blanca	Buenos Aires	156924	144648	301572	105342	124721	102037
06063	06	Balcarce	Buenos Aires	22303	21520	43823	14720	17444	14022
06070	06	Baradero	Buenos Aires	16568	16193	32761	10416	12301	10001
06084	06	Benito Juárez	Buenos Aires	10000	10239	20239	6786	8437	6638
06091	06	Berazategui	Buenos Aires	165636	158608	324244	93164	96025	86248
06098	06	Berisso	Buenos Aires	45458	43012	88470	27449	29507	25778
06105	06	Bolívar	Buenos Aires	17362	16828	34190	12002	15141	11708
06112	06	Bragado	Buenos Aires	21311	20025	41336	14291	16519	13457
06119	06	Brandsen	Buenos Aires	13303	13064	26367	8324	10550	8016
06126	06	Campana	Buenos Aires	47190	47271	94461	28111	31867	25977
06134	06	Cañuelas	Buenos Aires	25972	25920	51892	15312	18269	14650
06140	06	Capitán Sarmiento	Buenos Aires	7436	7058	14494	4672	5227	4481
06147	06	Carlos Casares	Buenos Aires	11381	10856	22237	7775	9446	7504
06154	06	Carlos Tejedor	Buenos Aires	5764	5806	11570	3976	5011	3832
06161	06	Carmen de Areco	Buenos Aires	7364	7328	14692	4631	5571	4498
06168	06	Castelli	Buenos Aires	4208	3997	8205	2721	3371	2666
06210	06	Chacabuco	Buenos Aires	25013	23690	48703	16496	18929	15624
06217	06	Chascomús	Buenos Aires	21570	20707	42277	13903	17593	13425
06224	06	Chivilcoy	Buenos Aires	33441	30744	64185	22083	27055	21275
06175	06	Colón	Buenos Aires	12781	12109	24890	8191	9254	7926
06182	06	Coronel de Marina Leonardo Rosales	Buenos Aires	31739	30413	62152	19424	23385	18705
06189	06	Coronel Dorrego	Buenos Aires	8124	7701	15825	5689	7691	5586
06196	06	Coronel Pringles	Buenos Aires	11818	11115	22933	8097	10026	7888
06203	06	Coronel Suárez	Buenos Aires	19568	18752	38320	13451	16878	13104
06231	06	Daireaux	Buenos Aires	8487	8402	16889	5479	6571	5284
06238	06	Dolores	Buenos Aires	13981	13061	27042	9004	10553	8767
06245	06	Ensenada	Buenos Aires	28939	27790	56729	17443	19343	16486
06252	06	Escobar	Buenos Aires	107602	106017	213619	59981	65378	54876
06260	06	Esteban Echeverría	Buenos Aires	152979	147980	300959	85952	88153	77955
06266	06	Exaltación de la Cruz	Buenos Aires	14882	14923	29805	9101	12685	8626
06270	06	Ezeiza	Buenos Aires	81820	81902	163722	44487	49204	41661
06274	06	Florencio Varela	Buenos Aires	213096	212909	426005	113135	113989	104128
06277	06	Florentino Ameghino	Buenos Aires	4450	4419	8869	2986	3895	2923
06280	06	General Alvarado	Buenos Aires	20190	19404	39594	12732	25095	12339
06287	06	General Alvear	Buenos Aires	4850	6280	11130	3308	4099	3174
06294	06	General Arenales	Buenos Aires	7635	7268	14903	5327	6819	5248
06301	06	General Belgrano	Buenos Aires	8882	8483	17365	6008	7962	5879
06308	06	General Guido	Buenos Aires	1372	1444	2816	1005	1495	998
06315	06	General Juan Madariaga	Buenos Aires	10220	9527	19747	6332	7636	6162
06322	06	General La Madrid	Buenos Aires	5455	5328	10783	3777	4982	3689
06329	06	General Las Heras	Buenos Aires	7614	7275	14889	4641	5470	4466
06336	06	General Lavalle	Buenos Aires	1807	1893	3700	1176	1659	1146
06343	06	General Paz	Buenos Aires	5642	5560	11202	3782	5276	3647
06351	06	General Pinto	Buenos Aires	5622	5639	11261	3888	5124	3820
06357	06	General Pueyrredón	Buenos Aires	323695	295294	618989	209794	307404	201039
06364	06	General Rodríguez	Buenos Aires	43964	43221	87185	24926	29309	22724
06371	06	General San Martín	Buenos Aires	216102	198094	414196	133202	138011	121392
06385	06	General Viamonte	Buenos Aires	9184	8894	18078	6286	7751	6172
06392	06	General Villegas	Buenos Aires	15310	15554	30864	10342	12604	10120
06399	06	Guaminí	Buenos Aires	5898	5928	11826	4224	5387	4134
06406	06	Hipólito Yrigoyen	Buenos Aires	4846	4739	9585	3295	3992	3206
06408	06	Hurlingham	Buenos Aires	93963	87278	181241	55122	55440	50403
06410	06	Ituzaingó	Buenos Aires	86636	81188	167824	51444	54363	48074
06412	06	José C. Paz	Buenos Aires	134690	131291	265981	71722	72231	65708
06413	06	Junín	Buenos Aires	46841	43464	90305	30315	35494	29073
06420	06	La Costa	Buenos Aires	35394	34239	69633	23949	97857	23241
06427	06	La Matanza	Buenos Aires	909126	866690	1775816	484909	447306	405338
06441	06	La Plata	Buenos Aires	339061	315263	654324	221313	259352	209888
06434	06	Lanús	Buenos Aires	240390	218873	459263	149594	157867	137132
06448	06	Laprida	Buenos Aires	5270	4940	10210	3472	4306	3373
06455	06	Las Flores	Buenos Aires	12353	11518	23871	8213	10029	7924
06462	06	Leandro N. Alem	Buenos Aires	8584	8215	16799	5783	6950	5653
06469	06	Lincoln	Buenos Aires	21303	20505	41808	14528	17372	14063
06476	06	Lobería	Buenos Aires	8733	8790	17523	5902	7189	5750
06483	06	Lobos	Buenos Aires	18675	17497	36172	11749	13700	11007
06490	06	Lomas de Zamora	Buenos Aires	319237	297042	616279	188844	188186	167304
06497	06	Luján	Buenos Aires	54088	52185	106273	32524	37527	30978
06505	06	Magdalena	Buenos Aires	8653	10648	19301	5358	6892	5145
06511	06	Maipú	Buenos Aires	5339	4849	10188	3447	4332	3369
06515	06	Malvinas Argentinas	Buenos Aires	163170	159205	322375	89338	87283	80186
06518	06	Mar Chiquita	Buenos Aires	10674	10605	21279	7115	14266	6905
06525	06	Marcos Paz	Buenos Aires	26379	27802	54181	14656	16621	14029
06532	06	Mercedes	Buenos Aires	32230	31054	63284	20214	23564	19343
06539	06	Merlo	Buenos Aires	269077	259417	528494	147716	147221	135383
06547	06	Monte	Buenos Aires	10676	10358	21034	6587	8542	6376
06553	06	Monte Hermoso	Buenos Aires	3173	3326	6499	2331	10105	2270
06560	06	Moreno	Buenos Aires	228214	224291	452505	124016	129560	114125
06568	06	Morón	Buenos Aires	167980	153129	321109	106902	117303	100936
06574	06	Navarro	Buenos Aires	8583	8471	17054	5321	6691	5210
06581	06	Necochea	Buenos Aires	48513	44420	92933	31425	41778	30285
06595	06	Olavarría	Buenos Aires	56420	55288	111708	36865	43194	35843
06602	06	Patagones	Buenos Aires	15207	15000	30207	10183	13234	9801
06609	06	Pehuajó	Buenos Aires	20522	19254	39776	13805	17041	13495
06616	06	Pellegrini	Buenos Aires	2971	2916	5887	2100	2545	2006
06623	06	Pergamino	Buenos Aires	55323	49267	104590	34768	39485	33511
06630	06	Pila	Buenos Aires	1806	1834	3640	1215	1676	1197
06638	06	Pilar	Buenos Aires	150624	148453	299077	82671	93531	75816
06644	06	Pinamar	Buenos Aires	12908	12820	25728	8205	24369	7744
06648	06	Presidente Perón	Buenos Aires	40891	40250	81141	21422	22499	20122
06651	06	Puán	Buenos Aires	8019	7724	15743	6328	8417	6243
06655	06	Punta Indio	Buenos Aires	4951	4937	9888	3413	5163	3361
06658	06	Quilmes	Buenos Aires	301015	281928	582943	177110	182216	163717
06665	06	Ramallo	Buenos Aires	16722	16320	33042	10201	11515	9842
06672	06	Rauch	Buenos Aires	7726	7450	15176	5325	6521	5200
06679	06	Rivadavia	Buenos Aires	8364	8779	17143	5483	6590	5239
06686	06	Rojas	Buenos Aires	12050	11382	23432	8010	9948	7717
06693	06	Roque Pérez	Buenos Aires	6293	6220	12513	4295	5280	4216
06700	06	Saavedra	Buenos Aires	10235	10514	20749	7315	9147	7187
06707	06	Saladillo	Buenos Aires	16420	15683	32103	10768	13352	10512
06721	06	Salliqueló	Buenos Aires	4427	4217	8644	3162	3859	3098
06714	06	Salto	Buenos Aires	16684	15969	32653	10689	12442	10372
06728	06	San Andrés de Giles	Buenos Aires	11518	11509	23027	7284	8565	7043
06735	06	San Antonio de Areco	Buenos Aires	11785	11353	23138	7191	8294	6845
06742	06	San Cayetano	Buenos Aires	4230	4169	8399	2961	3783	2904
06749	06	San Fernando	Buenos Aires	84595	78645	163240	49384	51910	44745
06756	06	San Isidro	Buenos Aires	154471	138407	292878	97213	107600	91830
06760	06	San Miguel	Buenos Aires	141606	134584	276190	80627	82879	72989
06763	06	San Nicolás	Buenos Aires	74686	71171	145857	45051	48455	42725
06770	06	San Pedro	Buenos Aires	29970	29066	59036	18441	20684	17409
06778	06	San Vicente	Buenos Aires	30190	29288	59478	17116	19287	16377
06784	06	Suipacha	Buenos Aires	5106	4975	10081	3204	3846	3120
06791	06	Tandil	Buenos Aires	63967	59904	123871	43155	50450	41764
06798	06	Tapalqué	Buenos Aires	4642	4536	9178	3163	4152	3105
06805	06	Tigre	Buenos Aires	191607	184774	376381	108558	118416	98616
06812	06	Tordillo	Buenos Aires	836	928	1764	558	782	536
06819	06	Tornquist	Buenos Aires	6369	6354	12723	4538	7668	4472
06826	06	Trenque Lauquen	Buenos Aires	21967	21054	43021	14519	17197	13772
06833	06	Tres Arroyos	Buenos Aires	29390	27720	57110	20114	28782	19418
06840	06	Tres de Febrero	Buenos Aires	178265	161806	340071	112588	119907	104154
06847	06	Tres Lomas	Buenos Aires	4409	4291	8700	2894	3426	2845
06861	06	Vicente López	Buenos Aires	143628	125792	269420	99286	114728	94989
06868	06	Villa Gesell	Buenos Aires	15810	15920	31730	10374	30793	9971
06875	06	Villarino	Buenos Aires	15337	15677	31014	9890	12401	9553
06882	06	Zárate	Buenos Aires	57299	56970	114269	34013	36007	31115
10007	10	Ambato	Catamarca	2142	2321	4463	1294	3093	1250
10014	10	Ancasti	Catamarca	1354	1563	2917	786	1075	756
10021	10	Andalgalá	Catamarca	9019	9113	18132	4697	6203	4469
10028	10	Antofagasta de la Sierra	Catamarca	613	823	1436	365	736	356
10035	10	Belén	Catamarca	13601	14242	27843	6817	8142	6288
10042	10	Capayán	Catamarca	7671	8414	16085	3927	5072	3779
10049	10	Capital	Catamarca	82902	76801	159703	42037	44606	38408
10056	10	El Alto	Catamarca	1670	1900	3570	1042	1666	1015
10063	10	Fray Mamerto Esquiú	Catamarca	5963	5933	11896	3019	3482	2844
10070	10	La Paz	Catamarca	11139	11499	22638	6093	7364	5768
10077	10	Paclín	Catamarca	1961	2224	4185	1152	1983	1080
10084	10	Pomán	Catamarca	5201	5575	10776	2746	3459	2657
10091	10	Santa María	Catamarca	11542	11006	22548	5982	7573	5513
10098	10	Santa Rosa	Catamarca	5711	6323	12034	3096	3605	2914
10105	10	Tinogasta	Catamarca	11153	11207	22360	6066	8038	5818
10112	10	Valle Viejo	Catamarca	13877	13365	27242	6882	7537	6461
22036	22	12 de Octubre	Chaco	11025	11256	22281	6021	6813	5769
22126	22	1º de Mayo	Chaco	5171	5151	10322	2954	3524	2849
22039	22	2 de Abril	Chaco	3694	3738	7432	2121	2420	2018
22168	22	25 de Mayo	Chaco	14524	14691	29215	7532	7663	6758
22105	22	9 de Julio	Chaco	14405	14150	28555	7798	8565	7416
22007	22	Almirante Brown	Chaco	16711	17364	34075	8730	10123	7995
22014	22	Bermejo	Chaco	12505	12547	25052	7128	7945	6799
22028	22	Chacabuco	Chaco	15623	14967	30590	8494	9089	8003
22021	22	Comandante Fernández	Chaco	49857	47087	96944	27000	29188	24798
22043	22	Fray Justo Santa María de Oro	Chaco	5723	6103	11826	3229	3554	3077
22049	22	General Belgrano	Chaco	5972	6016	11988	3078	3554	2931
22056	22	General Donovan	Chaco	6674	6816	13490	3698	4023	3576
22063	22	General Güemes	Chaco	33040	34092	67132	17243	19116	16065
22070	22	Independencia	Chaco	11220	11191	22411	5417	6254	5201
22077	22	Libertad	Chaco	6073	6085	12158	3237	3592	3101
22084	22	Libertador General San Martín	Chaco	29404	29743	59147	15797	17245	15129
22091	22	Maipú	Chaco	12463	12825	25288	6346	6872	6103
22098	22	Mayor Luis J. Fontana	Chaco	28261	26819	55080	15495	16558	14388
22112	22	O'Higgins	Chaco	10137	9994	20131	5184	6075	5002
22119	22	Presidencia de la Plaza	Chaco	6359	6140	12499	3416	3574	3184
22133	22	Quitilipi	Chaco	17071	17010	34081	8809	9207	8276
22140	22	San Fernando	Chaco	202311	188563	390874	110180	116778	102755
22147	22	San Lorenzo	Chaco	7341	7361	14702	3992	4449	3759
22154	22	Sargento Cabral	Chaco	7774	8115	15889	4367	4947	4068
22161	22	Tapenagá	Chaco	1971	2126	4097	1156	1474	1113
26007	26	Biedma	Chubut	41697	41186	82883	24471	27851	23008
26014	26	Cushamen	Chubut	10357	10562	20919	6714	7955	5968
26021	26	Escalante	Chubut	92788	93795	186583	56875	62051	52770
26028	26	Florentino Ameghino	Chubut	704	923	1627	479	648	460
26035	26	Futaleufú	Chubut	22033	21043	43076	13740	15320	12833
26042	26	Gaiman	Chubut	5366	5775	11141	3508	4202	3279
26049	26	Gastre	Chubut	606	821	1427	512	663	421
26056	26	Languiñeo	Chubut	1377	1708	3085	1073	1337	957
26063	26	Mártires	Chubut	318	460	778	287	387	260
26070	26	Paso de Indios	Chubut	805	1062	1867	649	897	633
26077	26	Rawson	Chubut	66917	64396	131313	41187	47080	39372
26084	26	Río Senguer	Chubut	2680	3299	5979	1984	2605	1848
26091	26	Sarmiento	Chubut	5498	5898	11396	3262	3890	3059
26098	26	Tehuelches	Chubut	2545	2845	5390	1793	2217	1717
26105	26	Telsen	Chubut	768	876	1644	632	882	591
02001	02	Comuna 1	Ciudad Autónoma de Buenos Aires	107789	98097	205886	84468	130771	78360
02010	02	Comuna 10	Ciudad Autónoma de Buenos Aires	89050	76972	166022	61453	71572	58332
02011	02	Comuna 11	Ciudad Autónoma de Buenos Aires	101363	88469	189832	71460	84649	68652
02012	02	Comuna 12	Ciudad Autónoma de Buenos Aires	107589	92527	200116	78547	93409	74995
02013	02	Comuna 13	Ciudad Autónoma de Buenos Aires	127499	103832	231331	100506	129633	97732
02014	02	Comuna 14	Ciudad Autónoma de Buenos Aires	125389	100581	225970	102918	141222	99552
02015	02	Comuna 15	Ciudad Autónoma de Buenos Aires	98089	84485	182574	72465	86326	69033
02002	02	Comuna 2	Ciudad Autónoma de Buenos Aires	89890	68042	157932	73156	107967	70869
02003	02	Comuna 3	Ciudad Autónoma de Buenos Aires	101936	85601	187537	80489	101161	75605
02004	02	Comuna 4	Ciudad Autónoma de Buenos Aires	115079	103166	218245	76455	82926	69680
02005	02	Comuna 5	Ciudad Autónoma de Buenos Aires	98199	80806	179005	76846	92750	73226
02006	02	Comuna 6	Ciudad Autónoma de Buenos Aires	97206	78870	176076	75189	93368	72942
02007	02	Comuna 7	Ciudad Autónoma de Buenos Aires	118110	102481	220591	81483	89520	73034
02008	02	Comuna 8	Ciudad Autónoma de Buenos Aires	97692	89545	187237	58204	55377	48631
02009	02	Comuna 9	Ciudad Autónoma de Buenos Aires	85590	76207	161797	56495	63322	52355
14007	14	Calamuchita	Córdoba	27400	27330	54730	16915	27312	16270
14014	14	Capital	Córdoba	695263	634341	1329604	414237	472417	383594
14021	14	Colón	Córdoba	114975	110176	225151	63780	74060	60380
14028	14	Cruz del Eje	Córdoba	29629	29130	58759	15948	18638	15265
14035	14	General Roca	Córdoba	17604	18041	35645	11608	13752	11340
14042	14	General San Martín	Córdoba	65037	62417	127454	41871	50236	40341
14049	14	Ischilín	Córdoba	16153	15159	31312	8734	10712	8389
14056	14	Juárez Celman	Córdoba	30588	30490	61078	19745	22833	19211
14063	14	Marcos Juárez	Córdoba	53233	50972	104205	35476	40874	34404
14070	14	Minas	Córdoba	2294	2433	4727	1495	2105	1447
14077	14	Pocho	Córdoba	2611	2769	5380	1611	2327	1563
14084	14	Presidente Roque Sáenz Peña	Córdoba	18377	17905	36282	12111	14350	11895
14091	14	Punilla	Córdoba	93131	85270	178401	55253	80893	52983
14098	14	Río Cuarto	Córdoba	126680	119713	246393	80878	100246	78485
14105	14	Río Primero	Córdoba	23445	23230	46675	13652	16553	13142
14112	14	Río Seco	Córdoba	6532	6710	13242	3846	5051	3688
14119	14	Río Segundo	Córdoba	53105	50613	103718	32090	36622	30976
14126	14	San Alberto	Córdoba	18665	18339	37004	10320	14649	9816
14133	14	San Javier	Córdoba	27514	26006	53520	15855	19301	15006
14140	14	San Justo	Córdoba	105083	101224	206307	66832	76481	64404
14147	14	Santa María	Córdoba	48958	49230	98188	28144	35783	26707
14154	14	Sobremonte	Córdoba	2213	2378	4591	1311	1638	1233
14161	14	Tercero Arriba	Córdoba	56406	53148	109554	36058	42429	35121
14168	14	Totoral	Córdoba	9237	9319	18556	5363	6713	5142
14175	14	Tulumba	Córdoba	6177	6496	12673	4041	5563	3944
14182	14	Unión	Córdoba	53478	52249	105727	34669	40673	33807
18007	18	Bella Vista	Corrientes	18699	18482	37181	9823	10478	9334
18014	18	Berón de Astrada	Corrientes	1201	1260	2461	676	884	662
18021	18	Capital	Corrientes	186762	171461	358223	96993	100816	86544
18028	18	Concepción	Corrientes	10232	10881	21113	5205	5858	5024
18035	18	Curuzú Cuatiá	Corrientes	22765	21619	44384	12446	13796	11901
18042	18	Empedrado	Corrientes	7642	7467	15109	4055	4757	3905
18049	18	Esquina	Corrientes	15691	15111	30802	8108	9071	7770
18056	18	General Alvear	Corrientes	4007	3919	7926	2387	2885	2287
18063	18	General Paz	Corrientes	7431	7405	14836	4119	4706	3934
18070	18	Goya	Corrientes	46645	43314	89959	24344	25802	22914
18077	18	Itatí	Corrientes	4634	4537	9171	2456	2865	2385
18084	18	Ituzaingó	Corrientes	15456	15694	31150	8367	10319	7918
18091	18	Lavalle	Corrientes	14113	14646	28759	7312	8113	7108
18098	18	Mburucuyá	Corrientes	4691	4561	9252	2524	3167	2482
18105	18	Mercedes	Corrientes	20591	20076	40667	11172	12684	10638
18112	18	Monte Caseros	Corrientes	18160	18178	36338	10543	11495	10119
18119	18	Paso de los Libres	Corrientes	24804	23838	48642	13254	13632	12053
18126	18	Saladas	Corrientes	11306	10938	22244	5638	6371	5470
18133	18	San Cosme	Corrientes	7137	7244	14381	3882	6589	3690
18140	18	San Luis del Palmar	Corrientes	8986	8604	17590	4417	4936	4253
18147	18	San Martín	Corrientes	6599	6541	13140	3661	4343	3525
18154	18	San Miguel	Corrientes	5286	5286	10572	2553	2893	2473
18161	18	San Roque	Corrientes	9293	9073	18366	4684	5278	4513
18168	18	Santo Tomé	Corrientes	30775	30522	61297	16664	17917	15472
18175	18	Sauce	Corrientes	4614	4418	9032	2514	2989	2470
30008	30	Colón	Entre Ríos	31300	30860	62160	19963	24140	19064
30015	30	Concordia	Entre Ríos	86204	83829	170033	47982	51372	44961
30021	30	Diamante	Entre Ríos	23893	22468	46361	14784	17362	14252
30028	30	Federación	Entre Ríos	34242	34494	68736	19378	21396	18437
30035	30	Federal	Entre Ríos	12998	12865	25863	7408	8637	7222
30042	30	Feliciano	Entre Ríos	7553	7526	15079	3949	4469	3791
30049	30	Gualeguay	Entre Ríos	26574	25309	51883	16153	18519	15312
30056	30	Gualeguaychú	Entre Ríos	56001	53460	109461	34492	40374	33057
30063	30	Islas del Ibicuy	Entre Ríos	5833	6244	12077	3445	4695	3369
30070	30	La Paz	Entre Ríos	34142	32761	66903	18305	20276	17440
30077	30	Nogoyá	Entre Ríos	19839	19187	39026	12207	14242	11878
30084	30	Paraná	Entre Ríos	176481	163449	339930	105030	117433	99572
30088	30	San Salvador	Entre Ríos	8703	8654	17357	5257	5877	5110
30091	30	Tala	Entre Ríos	13079	12586	25665	8406	10002	8143
30098	30	Uruguay	Entre Ríos	51407	49321	100728	32573	36399	30893
30105	30	Victoria	Entre Ríos	18203	17564	35767	11063	13689	10604
30113	30	Villaguay	Entre Ríos	24976	23989	48965	14726	16709	14145
34007	34	Bermejo	Formosa	6507	7539	14046	3548	4267	3284
34014	34	Formosa	Formosa	121272	113082	234354	62621	64586	56190
34021	34	Laishi	Formosa	8291	8772	17063	4538	5509	4360
34028	34	Matacos	Formosa	7237	7138	14375	3363	4044	3202
34035	34	Patiño	Formosa	33454	35127	68581	18856	22025	17939
34042	34	Pilagás	Formosa	8874	9525	18399	4794	5842	4696
34049	34	Pilcomayo	Formosa	43187	41837	85024	21932	24045	20504
34056	34	Pirané	Formosa	32208	32358	64566	17855	21207	17294
34063	34	Ramón Lista	Formosa	6737	7017	13754	2796	2933	2665
38007	38	Cochinoca	Jujuy	6662	5994	12656	3373	5105	3035
38021	38	Dr. Manuel Belgrano	Jujuy	137782	127467	265249	71061	74662	63119
38014	38	El Carmen	Jujuy	48198	48841	97039	23324	24230	19316
38028	38	Humahuaca	Jujuy	8924	8442	17366	4742	7344	4422
38035	38	Ledesma	Jujuy	40964	40826	81790	20345	22153	18354
38042	38	Palpalá	Jujuy	26717	25914	52631	13225	13840	11931
38049	38	Rinconada	Jujuy	1098	1390	2488	553	980	520
38056	38	San Antonio	Jujuy	2191	2275	4466	1239	1795	1136
38063	38	San Pedro	Jujuy	38083	36954	75037	19616	21799	18004
38070	38	Santa Bárbara	Jujuy	8552	9178	17730	4369	5026	3923
38077	38	Santa Catalina	Jujuy	1421	1379	2800	846	1553	759
38084	38	Susques	Jujuy	1890	1901	3791	854	1393	728
38094	38	Tilcara	Jujuy	6254	6095	12349	3397	4917	2995
38098	38	Tumbaya	Jujuy	2352	2306	4658	1284	1882	1149
38105	38	Valle Grande	Jujuy	1197	1254	2451	777	1601	727
38112	38	Yavi	Jujuy	11032	9774	20806	5625	7505	4793
42007	42	Atreucó	La Pampa	5037	5116	10153	3586	4448	3499
42014	42	Caleu Caleu	La Pampa	1125	1188	2313	741	1091	695
42021	42	Capital	La Pampa	54537	50775	105312	35598	42716	34483
42028	42	Catriló	La Pampa	3587	3706	7293	2389	2975	2304
42049	42	Chalileo	La Pampa	1443	1542	2985	947	1191	900
42056	42	Chapaleufú	La Pampa	5773	5847	11620	3984	4899	3890
42063	42	Chical Co	La Pampa	708	794	1502	474	657	462
42035	42	Conhelo	La Pampa	7048	7029	14077	4996	6333	4893
42042	42	Curacó	La Pampa	450	590	1040	360	522	347
42070	42	Guatraché	La Pampa	4374	4457	8831	3202	4008	3164
42077	42	Hucal	La Pampa	3705	3835	7540	2908	3892	2861
42084	42	Lihuel Calel	La Pampa	169	270	439	182	378	179
42091	42	Limay Mahuida	La Pampa	207	296	503	189	282	189
42098	42	Loventué	La Pampa	4277	4342	8619	2824	3739	2787
42105	42	Maracó	La Pampa	30145	28879	59024	19703	23201	19104
42112	42	Puelén	La Pampa	4541	4927	9468	2790	3339	2668
42119	42	Quemú Quemú	La Pampa	4323	4340	8663	3139	4017	3083
42126	42	Rancul	La Pampa	5298	5370	10668	3497	4565	3408
42133	42	Realicó	La Pampa	8136	8091	16227	5472	6796	5396
42140	42	Toay	La Pampa	6114	6295	12409	3836	5121	3743
42147	42	Trenel	La Pampa	2653	2773	5426	1852	2526	1815
42154	42	Utracán	La Pampa	7504	7335	14839	5005	6490	4927
46007	46	Arauco	La Rioja	7687	7731	15418	4109	4806	3917
46014	46	Capital	La Rioja	92433	88562	180995	48916	55482	45779
46021	46	Castro Barros	La Rioja	2109	2159	4268	1328	2219	1302
46035	46	Chamical	La Rioja	7124	7036	14160	4058	4789	3911
46042	46	Chilecito	La Rioja	24920	24512	49432	13300	15637	12640
46028	46	Coronel Felipe Varela	La Rioja	4771	4877	9648	2617	3533	2513
46049	46	Famatina	La Rioja	2874	2989	5863	1711	2605	1659
46056	46	General Angel V. Peñaloza	La Rioja	1448	1625	3073	867	1161	855
46063	46	General Belgrano	La Rioja	3684	3686	7370	2149	2723	2077
46070	46	General Juan F. Quiroga	La Rioja	1951	2157	4108	1123	1456	1100
46077	46	General Lamadrid	La Rioja	869	865	1734	484	657	475
46084	46	General Ocampo	La Rioja	3480	3665	7145	2096	2665	2047
46091	46	General San Martín	La Rioja	2448	2496	4944	1297	1633	1269
46105	46	Independencia	La Rioja	1192	1235	2427	643	868	629
46112	46	Rosario Vera Peñaloza	La Rioja	7064	6990	14054	3924	4714	3794
46119	46	San Blas de los Sauces	La Rioja	1993	1934	3927	1087	1691	1047
46126	46	Sanagasta	La Rioja	1168	1177	2345	622	1234	604
46098	46	Vinchina	La Rioja	1300	1431	2731	766	1094	749
50007	50	Capital	Mendoza	60983	54058	115041	39136	51236	36794
50014	50	General Alvear	Mendoza	23879	22550	46429	14748	16795	14113
50021	50	Godoy Cruz	Mendoza	100801	91102	191903	57375	59827	52897
50028	50	Guaymallén	Mendoza	146565	137238	283803	79770	82388	73330
50035	50	Junín	Mendoza	19197	18662	37859	10578	11073	9949
50042	50	La Paz	Mendoza	5030	4982	10012	2869	3114	2614
50049	50	Las Heras	Mendoza	104361	99305	203666	53978	55584	49369
50056	50	Lavalle	Mendoza	18128	18610	36738	9269	10187	8612
50063	50	Luján de Cuyo	Mendoza	60833	59055	119888	32233	37864	29548
50070	50	Maipú	Mendoza	87425	84907	172332	46569	47612	42411
50077	50	Malargüe	Mendoza	13551	14109	27660	7820	8556	7090
50084	50	Rivadavia	Mendoza	28635	27738	56373	15884	17196	14975
50091	50	San Carlos	Mendoza	16318	16313	32631	8985	9664	8430
50098	50	San Martín	Mendoza	60338	57882	118220	32730	34216	30409
50105	50	San Rafael	Mendoza	96967	91051	188018	56391	64108	54276
50112	50	Santa Rosa	Mendoza	8062	8312	16374	4438	5087	4205
50119	50	Tunuyán	Mendoza	25034	24424	49458	13538	14639	12690
50126	50	Tupungato	Mendoza	15991	16533	32524	8530	8910	7838
54119	54	25 de Mayo	Misiones	13517	14237	27754	7529	7976	7347
54007	54	Apóstoles	Misiones	21406	20843	42249	11556	12801	11057
54014	54	Cainguás	Misiones	26098	27305	53403	14387	15491	13998
54021	54	Candelaria	Misiones	13306	13734	27040	7299	8243	6903
54028	54	Capital	Misiones	169221	155535	324756	93120	100700	87471
54035	54	Concepción	Misiones	4796	4781	9577	2584	3077	2552
54042	54	Eldorado	Misiones	39318	38903	78221	21635	23598	20841
54049	54	General Manuel Belgrano	Misiones	20718	22184	42902	11042	11914	10435
54056	54	Guaraní	Misiones	32985	34912	67897	17789	19475	17382
54063	54	Iguazú	Misiones	40933	41294	82227	21466	23305	20617
54070	54	Leandro N. Alem	Misiones	22582	22493	45075	13063	14156	12731
54077	54	Libertador General San Martín	Misiones	23128	23433	46561	12751	14088	12500
54084	54	Montecarlo	Misiones	18314	18431	36745	9805	10746	9513
54091	54	Oberá	Misiones	53877	53624	107501	30016	33062	29240
54098	54	San Ignacio	Misiones	28786	28942	57728	15532	16931	14851
54105	54	San Javier	Misiones	10437	10469	20906	5714	6056	5412
54112	54	San Pedro	Misiones	14836	16215	31051	7665	8430	7413
58007	58	Aluminé	Neuquén	4035	4271	8306	2432	3537	2337
58014	58	Añelo	Neuquén	5109	5677	10786	3238	3990	3126
58021	58	Catán Lil	Neuquén	985	1170	2155	661	763	640
58042	58	Chos Malal	Neuquén	7649	7607	15256	4600	5523	4442
58028	58	Collón Curá	Neuquén	2229	2303	4532	1316	1613	1293
58035	58	Confluencia	Neuquén	185055	177618	362673	113864	125443	105919
58049	58	Huiliches	Neuquén	7362	7363	14725	4222	4807	4019
58056	58	Lácar	Neuquén	14959	14789	29748	9155	11321	8590
58063	58	Loncopué	Neuquén	3426	3499	6925	2000	2336	1870
58070	58	Los Lagos	Neuquén	5887	6111	11998	3623	4885	3473
58077	58	Minas	Neuquén	3496	3738	7234	2195	2654	1978
58084	58	Ñorquín	Neuquén	2209	2483	4692	1380	1964	1267
58091	58	Pehuenches	Neuquén	11107	12980	24087	7196	8565	6742
58098	58	Picún Leufú	Neuquén	2181	2397	4578	1461	1796	1428
58105	58	Picunches	Neuquén	3394	3628	7022	1979	2489	1915
58112	58	Zapala	Neuquén	18575	17974	36549	10735	12047	10263
62091	62	25 de Mayo	Río Negro	7683	8060	15743	4673	5508	4511
62049	62	9 de julio	Río Negro	1613	1862	3475	1123	1417	979
62007	62	Adolfo Alsina	Río Negro	29239	28439	57678	18345	22766	17651
62014	62	Avellaneda	Río Negro	17313	18010	35323	10549	12239	10165
62021	62	Bariloche	Río Negro	67514	65986	133500	41976	50455	40123
62028	62	Conesa	Río Negro	3517	3552	7069	2254	2758	2179
62035	62	El Cuy	Río Negro	2393	2887	5280	1869	2686	1749
62042	62	General Roca	Río Negro	163061	157860	320921	99433	111393	95146
62056	62	Ñorquinco	Río Negro	731	1005	1736	637	747	455
62063	62	Pichi Mahuida	Río Negro	7164	6943	14107	4687	5774	4587
62070	62	Pilcaniyeu	Río Negro	3659	3769	7428	2360	2971	2242
62077	62	San Antonio	Río Negro	14469	14815	29284	9230	15346	8837
62084	62	Valcheta	Río Negro	3515	3586	7101	2053	2549	1973
66007	66	Anta	Salta	28011	29400	57411	13688	14847	12489
66014	66	Cachi	Salta	3596	3719	7315	1811	2422	1704
66021	66	Cafayate	Salta	7462	7388	14850	3555	3553	2892
66028	66	Capital	Salta	279283	256830	536113	137000	136697	119603
66035	66	Cerrillos	Salta	17798	17991	35789	8505	9242	7549
66042	66	Chicoana	Salta	10344	10366	20710	4949	4993	4055
66049	66	General Güemes	Salta	23705	23521	47226	11562	12222	10540
66056	66	General José de San Martín	Salta	78572	78338	156910	37915	39928	34711
66063	66	Guachipas	Salta	1549	1638	3187	906	1191	849
66070	66	Iruya	Salta	3082	2905	5987	1504	2550	1366
66077	66	La Caldera	Salta	3806	3957	7763	2088	2578	1846
66084	66	La Candelaria	Salta	2765	2939	5704	1469	1751	1366
66091	66	La Poma	Salta	890	848	1738	423	621	365
66098	66	La Viña	Salta	3707	3728	7435	1869	2155	1465
66105	66	Los Andes	Salta	2923	3127	6050	1250	1796	1110
66112	66	Metán	Salta	20272	20079	40351	10128	10983	9312
66119	66	Molinos	Salta	2867	2785	5652	1191	1551	1105
66126	66	Orán	Salta	69140	69698	138838	31859	33365	29100
66133	66	Rivadavia	Salta	14578	15779	30357	7154	7901	6659
66140	66	Rosario de la Frontera	Salta	14707	14286	28993	7803	8407	7029
66147	66	Rosario de Lerma	Salta	19449	19253	38702	8968	10398	8117
66154	66	San Carlos	Salta	3478	3538	7016	1652	2108	1415
66161	66	Santa Victoria	Salta	5304	5040	10344	2545	3927	2428
70126	70	25 de Mayo	San Juan	8397	8722	17119	3973	4178	3704
70063	70	9 de Julio	San Juan	4680	4627	9307	2221	2363	2065
70007	70	Albardón	San Juan	12067	11821	23888	5863	6207	5398
70014	70	Angaco	San Juan	4050	4075	8125	2015	2226	1878
70021	70	Calingasta	San Juan	4026	4562	8588	2117	2915	2016
70028	70	Capital	San Juan	58726	50397	109123	34049	39218	31827
70035	70	Caucete	San Juan	19489	18854	38343	9452	9682	8852
70042	70	Chimbas	San Juan	44179	43079	87258	20846	20160	18619
70049	70	Iglesia	San Juan	3368	5731	9099	1753	2640	1680
70056	70	Jáchal	San Juan	10745	10985	21730	5365	6343	4996
70070	70	Pocito	San Juan	26780	26382	53162	13154	13852	12081
70077	70	Rawson	San Juan	58968	55400	114368	29520	29422	26331
70084	70	Rivadavia	San Juan	43017	39624	82641	21910	22660	20077
70091	70	San Martín	San Juan	5524	5591	11115	2675	2790	2477
70098	70	Santa Lucía	San Juan	24805	23282	48087	12724	12943	11291
70105	70	Sarmiento	San Juan	10719	11412	22131	5224	5586	4830
70112	70	Ullum	San Juan	2391	2495	4886	1230	1537	1189
70119	70	Valle Fértil	San Juan	3519	3703	7222	1868	2453	1792
70133	70	Zonda	San Juan	2377	2486	4863	1196	1480	1101
74007	74	Ayacucho	San Luis	9440	9647	19087	5534	6730	5261
74014	74	Belgrano	San Luis	1778	2207	3985	1294	2091	1246
74028	74	Chacabuco	San Luis	10363	10381	20744	6417	7833	6218
74021	74	Coronel Pringles	San Luis	6449	6708	13157	4055	5652	3862
74035	74	General Pedernera	San Luis	63868	62031	125899	36992	39486	34372
74042	74	Gobernador Dupuy	San Luis	5682	6097	11779	3508	4249	3394
74049	74	Junín	San Luis	14722	14211	28933	9033	11960	8638
74056	74	La Capital	San Luis	104417	99602	204019	58559	62166	53317
74063	74	Libertador General San Martín	San Luis	2184	2523	4707	1530	1882	1458
78007	78	Corpen Aike	Santa Cruz	5320	5773	11093	3481	4196	3299
78014	78	Deseado	Santa Cruz	52125	55505	107630	32187	36080	29629
78021	78	Güer Aike	Santa Cruz	55816	57451	113267	33809	38278	31702
78028	78	Lago Argentino	Santa Cruz	9155	9709	18864	5512	6806	5136
78035	78	Lago Buenos Aires	Santa Cruz	3848	4902	8750	2571	3228	2432
78042	78	Magallanes	Santa Cruz	4408	4794	9202	2807	3419	2664
78049	78	Río Chico	Santa Cruz	2205	2953	5158	1429	1874	1371
82077	82	9 de Julio	Santa Fe	14789	15043	29832	8744	10552	8412
82007	82	Belgrano	Santa Fe	22923	21865	44788	14481	16082	13675
82014	82	Caseros	Santa Fe	42320	39780	82100	27951	32510	26764
82021	82	Castellanos	Santa Fe	90299	87793	178092	56560	62458	53134
82028	82	Constitución	Santa Fe	44457	42453	86910	27693	30390	25971
82035	82	Garay	Santa Fe	10333	10557	20890	5860	7389	5571
82042	82	General López	Santa Fe	97843	93181	191024	64397	74256	62084
82049	82	General Obligado	Santa Fe	89444	86966	176410	49969	51437	45473
82056	82	Iriondo	Santa Fe	34124	32551	66675	21896	26030	21042
82063	82	La Capital	Santa Fe	274134	250959	525093	165133	182841	153098
82070	82	Las Colonias	Santa Fe	53272	51674	104946	34327	40178	33042
82084	82	Rosario	Santa Fe	622099	571506	1193605	392533	434485	354507
82091	82	San Cristóbal	Santa Fe	34859	34019	68878	21776	25236	20771
82098	82	San Javier	Santa Fe	15462	15497	30959	9103	10618	8737
82105	82	San Jerónimo	Santa Fe	40706	40134	80840	25662	30121	24356
82112	82	San Justo	Santa Fe	20780	20124	40904	13113	15278	12487
82119	82	San Lorenzo	Santa Fe	80587	76668	157255	48350	52180	44502
82126	82	San Martín	Santa Fe	32437	31405	63842	21473	24541	20787
82133	82	Vera	Santa Fe	25808	25686	51494	14756	17069	13956
86007	86	Aguirre	Santiago del Estero	3697	3913	7610	2087	2655	2023
86014	86	Alberdi	Santiago del Estero	8217	9035	17252	3980	4048	3461
86021	86	Atamisqui	Santiago del Estero	5490	5433	10923	2520	3122	2454
86028	86	Avellaneda	Santiago del Estero	10215	10548	20763	4897	5177	3897
86035	86	Banda	Santiago del Estero	72959	69320	142279	35244	38982	33132
86042	86	Belgrano	Santiago del Estero	4509	4734	9243	2473	2617	2157
86049	86	Capital	Santiago del Estero	139422	127703	267125	68793	78196	64348
86063	86	Choya	Santiago del Estero	17511	17156	34667	9465	11034	9030
86056	86	Copo	Santiago del Estero	15091	16313	31404	7522	8435	6659
86070	86	Figueroa	Santiago del Estero	8334	9486	17820	4084	4290	3709
86077	86	General Taboada	Santiago del Estero	19106	18999	38105	9073	9957	8319
86084	86	Guasayán	Santiago del Estero	3667	3935	7602	1950	2338	1795
86091	86	Jiménez	Santiago del Estero	6991	7361	14352	3586	2886	2019
86098	86	Juan F. Ibarra	Santiago del Estero	8811	9240	18051	4180	4444	3787
86105	86	Loreto	Santiago del Estero	10340	9696	20036	4782	5248	4418
86112	86	Mitre	Santiago del Estero	893	997	1890	536	644	521
86119	86	Moreno	Santiago del Estero	15643	16487	32130	7467	7174	6013
86126	86	Ojo de Agua	Santiago del Estero	7019	6989	14008	3784	4371	3471
86133	86	Pellegrini	Santiago del Estero	9864	10650	20514	5296	6286	4703
86140	86	Quebrachos	Santiago del Estero	5284	5284	10568	2807	3206	2599
86147	86	Río Hondo	Santiago del Estero	27742	27125	54867	13567	15181	11432
86154	86	Rivadavia	Santiago del Estero	2421	2594	5015	1468	1733	1379
86161	86	Robles	Santiago del Estero	22024	22391	44415	10609	11112	9201
86168	86	Salavina	Santiago del Estero	5372	5845	11217	2718	3307	2652
86175	86	San Martín	Santiago del Estero	4836	4995	9831	2261	2425	2066
86182	86	Sarmiento	Santiago del Estero	2215	2392	4607	1057	1315	1041
86189	86	Silípica	Santiago del Estero	3701	4011	7712	1819	1851	1620
94028	94	Antártida Argentina	Tierra del Fuego	29	161	190	8	8	8
94021	94	Islas del Atlántico Sur	Tierra del Fuego	0	17	17	0	0	0
94007	94	Río Grande	Tierra del Fuego	34095	35947	70042	21410	23298	19790
94014	94	Ushuaia	Tierra del Fuego	27826	29130	56956	17538	20054	16891
90007	90	Burruyacú	Tucumán	17972	18979	36951	8807	10335	8394
90084	90	Capital	Tucumán	287856	261010	548866	148773	157351	133408
90021	90	Chicligasta	Tucumán	41179	39556	80735	19864	20605	18348
90014	90	Cruz Alta	Tucumán	91276	89223	180499	42757	42951	38650
90028	90	Famaillá	Tucumán	17326	17216	34542	8019	8124	7251
90035	90	Graneros	Tucumán	6516	7035	13551	3481	4143	3367
90042	90	Juan B. Alberdi	Tucumán	15327	14910	30237	7554	8261	7148
90049	90	La Cocha	Tucumán	9424	9578	19002	4607	5043	4189
90056	90	Leales	Tucumán	27234	27715	54949	13663	15209	13127
90063	90	Lules	Tucumán	34529	33945	68474	16361	16869	14607
90070	90	Monteros	Tucumán	32217	31424	63641	15944	17168	14965
90077	90	Río Chico	Tucumán	28549	28298	56847	14088	14733	13097
90091	90	Simoca	Tucumán	14998	15878	30876	7875	8660	7488
90098	90	Tafí del Valle	Tucumán	7269	7664	14933	3972	8517	3793
90105	90	Tafí Viejo	Tucumán	62151	59487	121638	29772	31491	26614
90112	90	Trancas	Tucumán	8478	8893	17371	4441	6889	4204
90119	90	Yerba Buena	Tucumán	38500	36576	75076	18560	19691	17171
